aa: "death.attack.anvil": "%1$s was squashed by a falling anvil",
ab: "death.attack.anvil.player": "%1$s was squashed by a falling anvil while fighting %2$s",
ac: "death.attack.arrow": "%1$s was shot by %2$s",
ad: "death.attack.badRespawnPoint": "Intentional Game Design", (?)
# ae: "death.attack.badRespawnPoint.message": "%1$s was killed by %2$s",
af: "death.attack.cactus": "%1$s was pricked to death",
ag: "death.attack.cactus.player": "%1$s walked into a cactus while trying to escape %2$s",
ah: "death.attack.cramming": "%1$s was squished too much",
ai: "death.attack.cramming.player": "%1$s was squashed by %2$s",
aj: "death.attack.drown": "%1$s drowned",
ak: "death.attack.drown.player": "%1$s drowned while trying to escape %2$s",
al: "death.attack.explosion": "%1$s blew up",
am: "death.attack.explosion.player": "%1$s was blown up by %2$s",
an: "death.attack.fall": "%1$s hit the ground too hard",
ao: "death.attack.fall.player": "%1$s hit the ground too hard while trying to escape %2$s",
ap: "death.attack.fallingStalactite": "%1$s was skewered by a falling stalactite",
aq: "death.attack.fallingStalactite.player": "%1$s was skewered by a falling stalactite while fighting %2$s",
ar: "death.attack.fireball": "%1$s was fireballed by %2$s",
as: "death.attack.fireball.item": "%1$s was fireballed by %2$s using %3$s",
at: "death.attack.fireworks": "%1$s went off with a bang",
au: "death.attack.fireworks.player": "%1$s went off with a bang while fighting %2$s",
av: "death.attack.freeze": "%1$s froze to death",
aw: "death.attack.freeze.player": "%1$s was frozen to death by %2$s",
ax: "death.attack.hotFloor": "%1$s discovered the floor was lava",
ay: "death.attack.hotFloor.player": "%1$s walked into the danger zone due to %2$s",
az: "death.attack.inFire": "%1$s went up in flames",
ba: "death.attack.inFire.player": "%1$s walked into fire while fighting %2$s",
bb: "death.attack.inWall": "%1$s suffocated in a wall",
bc: "death.attack.inWall.player": "%1$s suffocated in a wall while fighting %2$s",
bd: "death.attack.indirectMagic": "%1$s was killed by %2$s using magic",
be: "death.attack.lava": "%1$s tried to swim in lava",
bf: "death.attack.lava.player": "%1$s tried to swim in lava to escape %2$s",
bg: "death.attack.mob": "%1$s was slain by %2$s",
bh: "death.attack.onFire": "%1$s burned to death",
bi: "death.attack.onFire.player": "%1$s was burned to a crisp while fighting %2$s",
bj: "death.attack.sonic_boom": "%1$s was obliterated by a sonically-charged shriek",
bk: "death.attack.stalagmite": "%1$s was impaled on a stalagmite",
bl: "death.attack.stalagmite.player": "%1$s was impaled on a stalagmite while fighting %2$s",
bm: "death.attack.sting": "%1$s was stung to death",
bn: "death.attack.sweetBerryBush": "%1$s was poked to death by a sweet berry bush",
bo: "death.attack.sweetBerryBush.player": "%1$s was poked to death by a sweet berry bush while trying to escape %2$s",
bp: "death.attack.thorns": "%1$s was killed while trying to hurt %2$s",
bq: "death.attack.trident": "%1$s was impaled by %2$s",
br: "death.attack.wither": "%1$s withered away",
bs: "death.attack.wither.player": "%1$s withered away while fighting %2$s",
bt: "death.fell.accident.generic": "%1$s fell from a high place",
bu: "death.fell.accident.ladder": "%1$s fell off a ladder",
bv: "death.fell.accident.other_climbable": "%1$s fell while climbing",
bw: "death.fell.accident.scaffolding": "%1$s fell off scaffolding",
bx: "death.fell.accident.twisting_vines": "%1$s fell off some twisting vines",
by: "death.fell.accident.vines": "%1$s fell off some vines",
bz: "death.fell.accident.weeping_vines": "%1$s fell off some weeping vines",
ca: "death.fell.killer": "%1$s was doomed to fall",